#####################
#S#         #       #
# ####### # ### ### #
#   #   # #   # # # #
### # # # ### # # # #
# # # #   # # # # # #
# # # ##### # # # # #
#   # #     # # #   #
# ### # ### # # #####
#   # # #   # #     #
### # # # ### # ### #
# # # # # #   #   # #
# # # # # # ##### # #
# # # # # #   #   # #
# # # # ##### ##### #
#   # #     # #   # #
# ### ### # # # # # #
#   #   # # # # # # #
### ### # # # # # # #
#       # #     #  G#
#####################
